111111
100001
152041
100001
111111
